Expected: سلمه	Got: سلم+ه	1
Expected: و+اتنقل	Got: واتنقل	1
Expected: هنا	Got: ه+نا	2
Expected: ل+هم	Got: +ل+هم	1
Expected: يوميا	Got: يوم+يا	1
Expected: و+القى	Got: و+ال+قى	1
Expected: التي	Got: ال+تي	2
Expected: و+اشار	Got: واشار	1
Expected: اصبح+ت	Got: اصبحت	1
Expected: ترك+ت	Got: تركت	1
Expected: منظر	Got: من+ظر	1
Expected: و+فمة	Got: وفمة	2
Expected: لا	Got: ل+ا	11
Expected: يشدك	Got: يشد+ك	1
Expected: كانو	Got: كان+و	1
Expected: طافي	Got: طاف+ي	1
Expected: ويل+و	Got: و+ي+ل+و	1
Expected: عندو+ش	Got: عند+و+ش	1
Expected: و+بوزيد	Got: و+ب+وزيد	1
Expected: مكسي	Got: مكس+ي	1
Expected: بوزيد	Got: ب+وزيد	2
Expected: تستاهلوش+بل	Got: تستاهلوشبل	1
Expected: و+اللي	Got: و+ال+لي	2
Expected: ماللي	Got: مال+ل+ي	1
Expected: و+الا	Got: و+ال+ا	2
Expected: اش	Got: ا+ش	7
Expected: و	Got: و+	55
Expected: او	Got: ا+و	4
Expected: اخترنا	Got: اختر+نا	1
Expected: ف+ال+سجن	Got: فالسجن	1
Expected: لوسيا	Got: ل+وس+يا	1
Expected: صربيا	Got: صرب+يا	1
Expected: بوليس	Got: ب+وليس	1
Expected: كنتو	Got: كنت+و	2
Expected: تتلاكشو	Got: تتلاكش+و	1
Expected: ب+نينا	Got: بني+نا	1
Expected: نينا	Got: ني+نا	1
Expected: اه	Got: ا+ه	1
Expected: ك+ال+قابض	Got: كالقابض	1
Expected: قاري	Got: قار+ي	1
Expected: و+فتحي	Got: و+فتح+ي	1
Expected: لطفي	Got: لطف+ي	4
Expected: ان+ي	Got: ا+ني	1
Expected: ب	Got: ب+	2
Expected: باهيه	Got: باهي+ه	1
Expected: ب+صفه	Got: ب+صف+ه	1
Expected: يوميه	Got: يومي+ه	1
Expected: تو	Got: ت+و	2
Expected: زعمه	Got: زعم+ه	1
Expected: تونسي	Got: تونس+ي	2
Expected: يقلي	Got: يقل+ي	1
Expected: شنوه	Got: شنو+ه	1
Expected: ها	Got: +ها	1
Expected: قمه	Got: قم+ه	1
Expected: موش	Got: م++و+ش	9
Expected: ل+هنا	Got: له+نا	3
Expected: لادن	Got: ل+ادن	1
Expected: بطاقات	Got: ب+طاقات	1
Expected: و+هي	Got: وه+ي	3
Expected: منتصف	Got: من+تصف	1
Expected: وضع	Got: و+ضع	1
Expected: اتو	Got: ات+و	1
Expected: و+هو	Got: و++هو	4
Expected: منذ	Got: من+ذ	2
Expected: يهن+ي	Got: يه+ني	1
Expected: نقصه+و+لو	Got: نقص+هو+ل+و	1
Expected: كل+و	Got: +ك+ل+و	1
Expected: كذلك	Got: كذل+ك	1
Expected: تونيزي	Got: تونيز+ي	1
Expected: الا	Got: ال+ا	1
Expected: ل+ها	Got: +ل+ها	2
Expected: ل+رئاسة	Got: لرئاسة	1
Expected: حتل+هم	Got: حت+ل+هم	1
Expected: منغوليا	Got: من+غول+يا	1
Expected: كوريا	Got: كور+يا	1
Expected: افريقيا	Got: افريق+يا	1
Expected: ليبيا	Got: ليب+يا	1
Expected: يقلقني+ش	Got: يقلق+ني+ش	1
Expected: عادي	Got: عاد+ي	1
Expected: هولو	Got: +هو+ل+و	1
Expected: ورنوا	Got: و+رنوا	1
Expected: مش	Got: م++ش	1
Expected: اش+يعملو	Got: اشيعمل+و	1
Expected: ماهو	Got: ما+هو	1
Expected: شي	Got: +شي	1
Expected: و+ال	Got: و+ال+	1
Expected: لباس	Got: ل+باس	1
Expected: و+الي	Got: و+ال+ي	1
Expected: ترصلي	Got: ترص+ل+ي	1
Expected: و+انا	Got: و+ا+نا	2
Expected: بسم	Got: ب+سم	1
Expected: لله	Got: ل+له	1
Expected: ولا	Got: و+ل+ا	1
Expected: م+يزالت	Got: ميزالت	1
Expected: و+دمتم	Got: ودمتم	1
Expected: وقف+نا	Got: و+قفنا	1
Expected: وجد+ك	Got: و+جد+ك	1
Expected: و+تعنا+ك	Got: وتعنا+ك	1
Expected: بالغ	Got: ب+ال+غ	1
Expected: قت+لي	Got: قتل+ي	1
Expected: التحق+ت	Got: ال+تحقت	1
Expected: ت+نظر	Got: تنظر	1
Expected: ت+واصل	Got: تواصل	1
Expected: ب+وجيعت+ي	Got: بوجيعت+ي	1
Expected: ها+ما	Got: هاما	1
Expected: وهد	Got: و+هد	1
Expected: لين	Got: ل+ين	1
Expected: و+لا	Got: و+ل+ا	3
Expected: يحرك	Got: يحر+ك	1
Expected: تبدو	Got: تبد+و	3
Expected: ترا+هما	Got: تراهما	1
Expected: منشغل	Got: من+شغل	1
Expected: مندهشة	Got: من+دهشة	1
Expected: وحد+ها	Got: و+حد+ها	1
Expected: فين	Got: في+ن	1
Expected: ب+اهتة	Got: باهتة	1
Expected: اهه	Got: اه+ه	1
Expected: و+عسى	Got: وعسى	1
Expected: ب+حذا	Got: بحذا	1
Expected: لان	Got: ل+ان	1
Expected: ماريا	Got: مار+يا	1
Expected: ها+نا	Got: هانا	1
Expected: قت+لي+ش	Got: قت+ل+ي+ش	1
Expected: خارجي	Got: خارج+ي	1
Expected: و+طونطون	Got: وطونطون	1
Expected: ل+ه	Got: +ل+ه	2
Expected: ساق+ي	Got: ساقي	1
Expected: ايجاو	Got: ايجا+و	1
Expected: تكبش	Got: تكب+ش	1
Expected: و+برا	Got: و+ب+را	1
Expected: ايه	Got: اي+ه	1
Expected: هاي	Got: ها+ي	1
Expected: الي+ها	Got: ال+يها	1
Expected: ولات	Got: و+لات	1
Expected: وقفة	Got: و+قفة	1
Expected: بما	Got: ب+ما	1
Expected: تغلي	Got: تغ+ل+ي	1
Expected: حزينا	Got: حزي+نا	2
Expected: و+لو	Got: و++ل+و	1
Expected: و+لكن	Got: و+ل+كن	1
Expected: و+الله	Got: و+ال+له	2
Expected: قات+لي	Got: قاتل+ي	1
Expected: بابا	Got: ب+ابا	1
Expected: داخلي	Got: داخل+ي	2
Expected: ينجمو+ش	Got: ينجم+و	1
Expected: كلي	Got: +ك+ل+ي	1
Expected: عطا+و+ني	Got: عطاو+ني	1
Expected: وسام	Got: و+سام	1
Expected: عندكش	Got: عند+ك+ش	1
Expected: يحكي+و+ه	Got: يحكيو+ه	1
Expected: نحو	Got: نح+و	1
Expected: ليلا	Got: ل+يلا	1
Expected: و+هاو	Got: و+ها+و	1
Expected: ل+دعاه	Got: ل+دعا+ه	1
Expected: يفسر+و+ل+و	Got: يفسرو+ل+و	1
Expected: تحلو	Got: تح+ل+و	1
Expected: و+تحطل+و	Got: و+تحط+ل+و	1
Expected: وحم	Got: و+حم	1
